. . # . . # # . . .
. # . . . . . . . .
. . . # . . . # . .
# . . . . . . . . .
. # . . # . . . . #
. . # . . . . # . .
. # . . . . . . . .
. . . # . . . # . .
# . . . . . # . . .
. # . . # . . . . .
